####################
#..................#
#..................#
#..................#
#..................#
#..................#
#..................#
#..................#
#..................#
P..................E
####################
....................
....................