########
#.....P#
#...S..#
#...####
#....D.#
##...#.#
##..-#.#
###..#.#
##..#..#
##B#..E#
########
........
........