####################
#..................E
#-##################
#......ss...ss.....#
#..................#
#...SSS..SSS..SSS..#
##################-#
#......ss...ss.....#
#..................#
P...SSS..SSS..SSS..#
####################
....................
....................