########
#.....P#
#......#
#...####
#..#####
#.######
#.##...#
#.#..#.#
#...#..#
#..#..E#
#.######
........
........