####################
P.#...#.D......#...#
#...#B#.###D-#B#-#.#
#S#.###...##..##.#.#
###.#####.##.B.D.#.#
#.......D.####-###.#
#.####B#######.....#
#.###############B##
#.D....D...D..######
#B####B###B##.....DE
####################
....................
....................