##############################
#............................#
#-##########################.#
#..........................#.#
##########################-#.#
#..........................#.#
#-##########################.#
#..........................#.#
##########################-#.#
P..........................#.E
##############################
..............................
..............................