####################
P.#s...###...s#.D..E
#.#..S.###.S..#.####
#.#--#B###B#--#-...#
#.#..#######..#....#
#.#..#######..#....#
#.#..#######..#...-#
#.#..#######..#....#
#.#..#######..#----#
#..................#
####################
....................
....................