####################
P....#.......##.D..E
####.#.#####B##.####
#....#.########....#
#.---#.###########-#
#......###########.#
##.....##########..#
###...............##
###................#
####..S..SSS...SS#B#
####################
....................
....................