####################
P.#................#
#.#B#.........D#...#
#.###..........#S..#
#.#............##..#
#.#..........D.##S.#
#.#............###.#
#.#...........##...#
#.#............#...#
#............#B#SS.E
###...##############
....................
....................