####################
#.s.s.#.......#...s#
#.....#.......#B#..#
#B#.#B#.......###..#
###.###.........##.#
##.................#
#............S###.##
#B.........DS####D.#
###........#######.#
P...........######.E
#######-#...########
....................
....................