####################
#...#...........s..E
#...#B#..........--#
#...###............#
#..............#...#
#...........D......#
#...........#......#
#.......#..........#
#...#..............#
P..................#
##.................#
....................
....................