####################
P..ss..............#
#..................#
#.--...S.........#.#
#.....S#S........#.#
#.....#.#....#...#.#
#............s####.#
#....-#S#-....#s##B#
#.....###.....s.s###
#................D.E
#...........-.-.-###
....................
....................