####################
#......s...#########
#........#.###...###
#...SSS..#.#...#B###
#---###--#B#--######
#........###.....###
#..................#
#................#B#
#....D.........D-###
P....#.........#..DE
##........--...#####
....................
....................