####################
#............#.....E
#............#B#...#
#........SSS.###..-#
#........###...#...#
#........###...#...#
#-......-###...#-..#
#........###......D#
#........###......##
P........###.......#
#.......-###-....--#
....................
....................